XXXXXXXXXXXXXXXXXXXXXXXXX
XXXXXXXXXXXXXXXXXXXXXXXXX
XXP X     T            XX
XX  X T         T      XX
XX  XXXXXXXXXXXXXXXXX  XX
XX  XXXXXXXXXXXXXXXXX  XX
XX        TXXXX        XX
XX  XXXXXX XXXX    G  TXX
XX  XXXXXX XXXX  XXXXXXXX
XX          XXX  XXXXXXXX
XX          XXX        XX
XX XXXXXXX  XXXXXXXXX  XX
XX XXXXXXX  XXXXXXXXX  XX
XX X          T        XX
XXTXE             G    XX
XXXXXXXXXXXXXXX  XXXXXXXX
XXTTXXXXXXXXXXX  XXXXXXXX
XX               XT    XX
XX   T           XT    XX
XXXXXXXXX  XXXXXXXXXX  XX
XXXXXXXXX  XXXXXXXXXX  XX
XXT              T     XX
XXT                    XX
XXXXXXXXXXXXXXXXXXXXXXXXX
XXXXXXXXXXXXXXXXXXXXXXXXX