XXXXXXXXXXXXXXXXXXXXXXXXXXXXXX
XPSSS  XX XX TX  X      XX G X
XXXXSXXXX  XX X XX XXXXXX  X X
X X STX XX X       XXX XX XXXX
X XXTXX      XXXXXXX        XX
X   S   XXXXXXXXXX XX XXXXX  X
X XXSXX             X   XXXXXX
XXXSS XX XX XXXXX X   X     XX
X SSXXX   X     X XX XXXXXX  X
XXSXXXXXX XX XX X XX     XXXXX
X SSX XX   XXXXXX  X XXX    XX
X XS G XXX  G   XXXXG  XXXX  X
X XSXXXX XXXX X    X X X  XXXX
X XTSSSSSSSXXXXXXXXXXXXXX  X X
X X X XX XS  X X XX X X X XX X
X XXX XXXXSXXX X XX X G X  X X
XXXX    XXSSTSSSSSX   XXX XX X
X    XXXXX XX XXXSSSXXXSSSSSSX
XX X     X XX  XX XSSSSSXX XEX
XXXXXXXXXXXXXXXXXXXXXXXXXXXXXX