XXXXXXXXXXXXXXXXXXXXXXXXXXXXXX
XP  X   X  X X X X        XX X
XXX XXX XX X X   XX XXXX XX  X
X X XX   T X XXX X    XXXXX XX
X X    X X    XX   XX X X X  X
X   XXXXXXXXX XX XXXXXX X X XX
X XXX XTX XXX X        GX    X
XXXX            X X XXXXX XX X
X  XXXXX XX XXX XXX       GXXX
XX X     X  XX    X X XX XXXXX
X    X X XX  XX X XXXXXX  G  X
XX X XXXXX  XX  X TX X XX XX X
X  X XX X  XXXX XX      XXXXXX
X XX X    XX     XX X XXXX XXX
X X  XX X  XX X XX  X        X
X XX  XXXXXXXXX XXX XXX XXXX X
X XX XX     T   X    GX   XXXX
X XX X  XX X XXTXX XGXX X    X
X  X XX X  X X  XX X  X X XXEX
XXXXXXXXXXXXXXXXXXXXXXXXXXXXXX