XXXXXXXXXXXXXXXXXXXXXXXXXXXXXX
XPSSX   X  X X X X        XX X
XXXSXXX XX X X   XX XXXX XX  X
X XSXXSSSTSX XXX X    XXXXX XX
X XSSSSX XSSSSXX   XX X X X  X
X   XXXXXXXXXSXX XXXXXX X X XX
X XXX XTX XXXSX        GX    X
XXXX         SSSX X XXXXX XX X
X  XXXXX XX XXXSXXX       GXXX
XX X     X  XX SSSX X XX XXXXX
X    X X XX  XX XSXXXXXX  G  X
XX X XXXXX  XX  XSTX X XX XX X
X  X XX X  XXXX XXSSSS  XXXXXX
X XX X    XX     XX XSXXXX XXX
X X  XX X  XX X XX  XSSS     X
X XX  XXXXXXXXX XXX XXXSXXXX X
X XX XX     T   X    GXSSSXXXX
X XX X  XX X XXTXX XGXX XSSSSX
X  X XX X  X X  XX X  X X XXEX
XXXXXXXXXXXXXXXXXXXXXXXXXXXXXX