XXXXXXXXXXXXXXXXXXXXXXXXXXXXXX
XP     XX XX TX  X      XX G X
XXXX XXXX  XX X XX XXXXXX  X X
X X  TX XX X       XXX XX XXXX
X XXTXX      XXXXXXX        XX
X       XXXXXXXXXX XX XXXXX  X
X XX XX             X   XXXXXX
XXX   XX XX XXXXX X   X     XX
X   XXX   X     X XX XXXXXX  X
XX XXXXXX XX XX X XX     XXXXX
X   X XX   XXXXXX  X XXX    XX
X X  G XXX  G   XXXXG  XXXX  X
X X XXXX XXXX X    X X X  XXXX
X XT       XXXXXXXXXXXXXX  X X
X X X XX X   X X XX X X X XX X
X XXX XXXX XXX X XX X G X  X X
XXXX    XX  T     X   XXX XX X
X    XXXXX XX XXX   XXX      X
XX X     X XX  XX X     XX XEX
XXXXXXXXXXXXXXXXXXXXXXXXXXXXXX